40
40
6

XXXXXXXXXXXXXXXXXXXXXXXXXXXXXXXXXXXXXXXX
X......................................X
X.........XXXXX........................X
X.........X...X........................X
X.........X...X.....X........X.........X
X.........X...X........................X
X.........XX.XX........................X
X......................................X
X......................................X
X......................................X
X......................................X
X......................................X
X......................................X
X..X...XXXXXX..........................X
X......X....X..........................X
X..X...X....X..........................X
X......XXXXXX..........................X
X...................................XXXX
X...................................XSSS
X......X............................XSSS
X...................................XSSS
X...................................XSSS
X...................................XSSS
X....X...X..........................XXXX
X......................................X
X....X...X.............................X
X......................................X
X.......................X..X...........X
X......................................X
X......................................X
X.......................X..X...........X
X....XXX.XXX...........................X
X....X.....X...........................X
X....X.....X...........................X
X....X.....X...........................X
XXXXXXXXXXXXXX.........................X
X....X.................................X
X....X.................................X
X....X.................................X
XXXXXXXXXXXXXXXXXXXXXXXXXXXXXXXXXXXXXXXX

XXXXXXXXXXXXXXXXXXXXXXXXXXXXXXXXXXXXXXXX
X......................................X
X.........XXXXX........................X
X.........X...X........................X
X.........X...X.....X........X.........X
X.........X...X........................X
X.........XX.XX........................X
X......................................X
X......................................X
X......................................X
X......................................X
X......................................X
X......................................X
X..X...................................X
X......................................X
X..X...................................X
X......................................X
X...................................XXXX
X...................................XSSS
X....................................SSS
X......X.............................SSS
X....................................SSS
X...................................XSSS
X....X...X..........................XXXX
X......................................X
X....X...X.............................X
X......................................X
X.......................XXXX...........X
X.......................XXXX...........X
X.......................XXXX...........X
X.......................XXXX...........X
X....XXX.XXX...........................X
X....X.....X...........................X
X....X.....X...........................X
X....X.....X...........................X
XXXXXXXXXXXXXX.........................X
X......................................X
X......................................X
X......................................X
XXXXXXXXXXXXXXXXXXXXXXXXXXXXXXXXXXXXXXXX

.X..X..X..X..X..X..X.X..X..X..X..X..X..X
........................................
X..........XXX.........................X
...........XXX..........................
...........XXX.....XXX......XXX.........
X..........XXX.........................X
...........XXX..........................
........................................
X......................................X
........................................
........................................
X......................................X
........................................
...X....................................
X..X...................................X
...X....................................
X.......................................
....................................X..X
........................................
X.......................................
........................................
.......X................................
X......X................................
.....XXXXX..........................X..X
.....XXXXX..............................
X....XXXXX..............................
.......................................X
........................................
X........................XX.............
.........................XX............X
........................................
X.......................................
......XXXXX............................X
......XXXXX.............................
X.....XXXXX.............................
.......................................X
........................................
X.......................................
.......................................X
.X..X..X..X..X..X..X..X..X..X..X..X..X..

........................................
........................................
........................................
............X...........................
............X.......X........X..........
............X...........................
........................................
........................................
........................................
........................................
........................................
........................................
........................................
........................................
........................................
........................................
........................................
........................................
........................................
........................................
........................................
........................................
........................................
........................................
........................................
........................................
........................................
........................................
........................................
........................................
........................................
........................................
........................................
.......XXX..............................
........................................
........................................
........................................
........................................
........................................
........................................

........................................
........................................
........................................
............X...........................
........................................
........................................
........................................
........................................
........................................
........................................
........................................
........................................
........................................
........................................
........................................
........................................
........................................
........................................
........................................
........................................
........................................
........................................
........................................
........................................
........................................
........................................
........................................
........................................
........................................
........................................
........................................
........................................
........................................
........................................
........................................
........................................
........................................
........................................
........................................
........................................

........................................
........................................
........................................
............X...........................
........................................
........................................
........................................
........................................
........................................
........................................
........................................
........................................
........................................
........................................
........................................
........................................
........................................
........................................
........................................
........................................
........................................
........................................
........................................
........................................
........................................
........................................
........................................
........................................
........................................
........................................
........................................
........................................
........................................
........................................
........................................
........................................
........................................
........................................
........................................
........................................
