10
10
2

XXXXXXXXXX
X........X
X....X...X
X........X
X....X...X
X........X
X........X
X...XXXX.X
X........X
XXXXXXXXXX

..........
..........
.....X....
.....X....
.....X....
..........
..........
....XXXX..
..........
..........